空空空空空空空空空空空空空
空砖空砖空砖空砖空砖空砖空
空铁空铁空铁空铁空铁空铁空
空砖空砖空砖空砖空砖空砖空
空砖空砖空砖空砖空砖空砖空
空空空空空空空空空空空空空
草铁空水水水水水水水空铁草
空砖草草草草草草草草草砖空
空砖空砖砖砖砖砖砖砖空砖空
空砖空砖砖砖砖砖砖砖空砖空
空砖空空空空空空空空空砖空
空砖空空空砖砖砖空空空砖空
空砖空空空砖空砖空坦空砖空